0000000000
2000000500
2000000500
0000000500
0000000500
0666000500
0000000004
0000000004
0003330004
0000000004