0000000020
0030000020
0030000000
0030004000
0000004000
0000004000
0000004000
0000000000
5555500000
0000006660