0000333000
0000000000
0000060000
0000060000
0000060000
0000000000
4005555500
4000000000
4000000200
4000000200