0000000000
0005555500
0000000000
3330000000
0000000000
0220400060
0000400060
0000400060
0000400000
0000000000