0000000005
0044440005
0000000005
0000000005
0000000005
0000000000
0030000220
0030000000
0030000000
0000066600